
NO ./textures/Minecraft_lapis.xpm
SO ./textures/Minecraft_gold.xpm
EA ./textures/Minecraft_diamond.xpm
WE ./textures/Minecraft_esmerald.xpm
DO ./textures/Door_2.xpm

F 1,1,1
C 2,2,2

111111111
101000001
101001001                              
111000001111111111111111111111111111
100000000000000000000000000000000001
1000000000000N0000000000D00000000001
100000000000000000000000000000000001
100010000000000000000000000001001001
100000000000000000000000000000000001
110001001111111111111111111111111111
100000001
100000001
111111111