
NO ./textures/north.xpm
SO ./textures/south.xpm
EA ./textures/east.xpm
WE ./textures/west.xpm

F 20,22,25
C 13,14,15

111111111
101000001
101000001
111000001111111111111111111111111111111111111111111111111111111111111111111111111111111111111111111111
1000000000000000000000000000000000000000000000000000000000000000000000000000000000000000000000N0000001
110001001111111111111111111111111111111111111111111111111111111111111111111111111111111111111111111111
100000001
100000001
111111111
