NO ./textures/north.xpm
SO ./textures/south.xpm
EA ./textures/east.xpm
WE ./textures/west.xpm

C 53,41,34
F 45,33,27

      111
     10001
    1000001
   1000N0001
  10000100001
 1000011100001
100001111100001
 1000011100001
  10000100001
   100000001
    1000001
     10001
      111